11111111111111111111111111
10010000000C110010000000C1
10000111110011000011111001
1P0011C000000000010C000001
11111111110001111100000111
10010000000C110010000000C1
10000111110000000011111001
100011C000001100011E000001
11111111111111111111111111
