1111111111111
100100C0000C1
10C0011111001
1P0011E0C0001
1111111111111
